W W W W W W W W W W
W 0 0 0 0 0 0 0 G W
W 0 0 0 P 0 0 0 0 W
W 0 0 0 0 0 0 0 0 W
W 0 0 0 0 0 P 0 0 W
W 0 0 0 0 0 0 0 0 W
W 0 0 0 0 0 0 0 0 W
W 0 0 0 P 0 0 0 0 W
W S 0 0 0 0 0 0 0 W
W W W W W W W W W W
